Patient Detail Table

Field Name	Data Type	Description
Patient ID	Integer
Name	Var Char	Name of the patient
Date of birth	Integer
Address	Var Char
Visited Location	Var Char
Date/Timing	DateTime
Last overseas travel	String	Yes/No
Covid Test	String	Positive/Negative
Status	String	Alive/Dead

Symptom Table

Field Name	Data Type	Description
Low Risk	Var Char	 Fever, Dry Cough
Medium Risk	Var Char
High Risk	Var char

High Risk Covid Location

Field Name	Data Type	Description
id	Var Char	Auburn Train Station
id	Var Char	Royal Hotel 